"F_______"
"____x__x"
"___x__x_"
"__x__x__"
"__x__x__"
"___x__x_"
"____x__x"
"_____x_S"