"S__xx__xxx"
"___xx__xx_"
"xx__x__x__"
"_______x__"
"__xx__x___"
"______x_x_"
"xx___xx__x"
"F___"