"S__xx__xxx"
"___xx__xx_"
"xx__x_____"
"____x_xxx_"
"__x_x_xxxF"
"______x_x_"
"xx_F_xx__x"