"_____xx____S"
"_____xx_____"
"_____xx_____"
"____________"
"_____xx_____"
"_____xx_____"
"F____xx_____"