"_____xx____S"
"_____xx*****"
"_____xx*____"
"__******____"
"***__xx_____"
"*____xx_____"
"F____xx_____"
