"S__xx__xxx"
"___xx__xxS"
"xx__x_____"
"____F_xxx_"
"__x_x_xxxx"
"______x_x_"
"xx_S_xx__x"