"S__xx__xxx"
"___xx__xx_"
"___x__x_x_"
"xx___xx__x"
"xxx_______"
"______xxx_"
"______xxxF"
